!*        ^           =!
 ================== = = 
 =X        =   =  =!= = 
 = ======= M =    = =X= 
 =^=     ========== === 
 = = = =   X      ^   = 
*= = = =*=#========== = 
 = =T=*= # @   *  =W= = 
 = = =X========== = = = 
 = = ===        = = = = 
^#       ====== =     = 
 =========    = ==#== = 
 =X       *K    ==  =X= 
 =========X======== === 
!            ^          
