======================   *
======================   *
======================   *
======================   *
======================   *
======================   *
======================   *
======================   *
=========fffffffff====   *
======================   *
======================   *
======================   *
======================   *
======================   *
========        k=====   *
======================   *
======================   *
======^^^^^^^^^=======   *
======================   *